#.#.#.#.#.#.#.#.#.#.#.#.#.#.#.#.#.#.#.#.#.#.#.#.#.#.#.#.#.#
...........................................................
#.........................................................#
...........................................................
#.........................................................#
...........................................................
#.........................................................#
...........................................................
#.........................................................#
.............................p.............................
#.........................................................#
...........................................................
#.........................................................#
...........................................................
#.........................................................#
...........................................................
#.........................................................#
...........................................................
#.........................................................#
...........................................................
#.........................................................#
...........................................................
#.#.#.#.#.#.#.#.#.#.#.#.#.#.#.#.#.#.#.#.#.#.#.#.#.#.#.#.#.#
