#.#.#.#.#.#.#.#.#.#.#.#.#.#.#.#.#.#.#.#.#.#.#.#.#.#.#.#.#.#
...........................................................
#.........................................................#
...........................................................
#.........................................................#
...........................................................
#.........................................................#
...........................................................
#.........................................................#
................................p..........................
#.........................................................#
...........................................................
#.........................................................#
...........................................................
#.........................................................#
...........................................................
#.........................................................#
...........................................................
#.........................................................#
...........................................................
#.........................................................#
...........................................................
#.#.#.#.#.#.#.#.#.#.#.#.#.#.#.#.#.#.#.#.#.#.#.#.#.#.#.#.#.#
