#.#.#.#.#.#.#.#.#.#.#.#.#.#.#.#.#.#.#.#.#.#.#.#.#.#.#.#.#.#
...........................................................
#.........................................................#
...........................................................
#..................#......................#...............#
...........................................................
#.........................................................#
...........................................................
#.........................................................#
.............................p............#................
#.........................................................#
...........................................................
#.........................................................#
..........................................#................
#.........................................................#
...................#.......................................
#.........................................................#
...........................................................
#......................................#..#...............#
...........................................................
#.........................................................#
...........................................................
#.#.#.#.#.#.#.#.#.#.#.#.#.#.#.#.#.#.#.#.#.#.#.#.#.#.#.#.#.#
