#.#.#.#.#.#.#.##.#.#.
.....................
#...................#
.....................
#......p............#
.....................
#...................#
.....................
#...................#
.....................
#...................#
.....................
#...................#
#....................
#...................#
#...................#
#.#.#.#.#.#.#.##.#.#.