#.#.#.#.#.#.#.#
...............
#.............#
...............
#......p......#
...............
#.............#
...............
#.#.#.#.#.#.#.#