###############
#.............#
#.............#
#.............#
#......p......#
#.............#
#.............#
#.............#
###############